▤▤▤▤▤▤▤▤▤▤▤▤▤▤▤▤▤▤▤▤▤▤▤▤▤▤▤▤▤▤▤▤▤▤▤▤▤▤▤▤▤▤▤▤▤▤▤▤▤▤▤▤▤▤▤▤▤▤▤▤▤▤▤▤▤▤▤▤▤▤▤▤▤▤▤▤▤▤▤▤
▤♣♣♣♣♣♣♣♣♣♣♣♣♣♣▤             ▤                 ▤   ▤▤     ▤      ▤   ▤   ▤    ▤▤
▤♣♣♣▤▤▤▤                     ▤                            ▤                    ▤
▤♣♣♣▤▤▤▤                                                     ▤▤▤▤▤▤▤▤▤▤▤▤▤▤▤▤▤▤▤
▤                            ▤            ♣♣♣♣♣           ▤                    ▤
▤♣♣♣  A                      ▤         ▤   ♣♣♣♣♣                               ▤
▤♣♣♣♣    ▤▤▤▤▤▤▤▤         ♣♣♣▤         ▤   ♣♣♣♣           ▤                    ▤
▤ ♣♣♣♣   ▤      ▤       ♣♣♣♣♣▤         ▤                  ▤                    ▤
▤  ♣     ▤      ▤          ♣♣▤         ▤▤▤▤▤▤▤▤▤▤▤        ▤     ♣♣♣♣♣♣♣♣♣♣♣♣♣♣♣▤
▤        ▤      ▤▤▤▤▤▤▤▤▤▤▤  ▤         ▤                  ▤       ♣♣♣♣♣♣♣♣♣♣♣♣♣▤
▤   ☺♣   ▤      O            ▤    ☠    ▤      ☠           ▤                    ▤
▤        ▤                   ▤         ▤                  ▤▤▤▤▤▤▤▤▤▤   ▤▤▤▤▤▤▤▤▤
▤        ▤▤▤▤▤▤▤▤▤▤▤▤▤▤▤▤▤▤▤▤▤▤▤▤▤▤▤▤▤▤▤                  ▤                    ▤
▤                            ▤♣♣♣♣♣    ▤ O             ♣♣♣▤▤▤  ▤▤▤▤▤▤▤▤▤▤▤▤▤▤▤▤▤
▤  ⌂     ⌂         ♣♣♣       ▤♣♣♣♣     ▤             ♣♣♣♣♣▤      ▤             ▤
▤                   ♣        ▤      ☠  ▤           ♣♣♣♣♣♣♣▤      ▤▤  ▤▤▤▤▤▤▤▤▤▤▤
▤  ▤▤▤▤▤▤▤▤▤▤▤▤▤▤▤▤▤▤▤▤▤▤▤   ▤         ▤           ▤▤▤▤▤▤▤▤▤▤▤   ▤             ▤
▤  ▤             ▤       ▤   ▤       ♣♣▤                  ▤♣♣♣♣  ▤▤▤▤▤▤▤▤▤   ▤▤▤
▤  ▤   ☠   ▤     ▤       ▤ ☠ ▤     ♣♣♣♣▤               ☠  ▤♣♣♣     ☠   ♣♣♣     ▤
▤  ▤       ▤  ⌂          ▤   ▤      ♣♣♣▤                  ▤▤▤▤▤▤▤▤▤▤▤▤▤▤▤▤▤▤▤▤ ▤
▤  ▤   ▤▤▤▤▤▤▤▤▤▤▤▤▤▤▤   ▤▤▤▤▤                            ▤       ♣♣♣♣♣♣♣♣♣♣♣♣♣▤
▤  ▤          ♣♣♣♣           ▤                            ▤      ♣♣♣♣♣♣♣♣♣♣♣♣♣♣▤
▤  ▤        ♣♣♣♣♣♣♣          ▤             ♣♣♣♣♣♣  ☠      ▤    ♣♣♣♣♣♣♣♣♣♣♣♣♣♣♣♣▤
▤  ▤  ▤▤▤▤▤▤▤▤▤▤▤▤▤▤▤▤▤▤▤▤▤▤▤▤            ♣♣♣♣♣♣          ▤   ♣♣♣♣♣♣♣♣♣♣♣♣♣♣♣♣♣▤
▤  ▤             ▤           ▤             ♣♣♣♣           ▤♣♣♣♣♣♣♣♣♣♣♣♣♣♣♣♣♣♣♣♣▤
▤  ▤▤▤▤▤▤▤▤  ⌂   ▤▤▤▤▤▤▤▤▤   ▤♣♣♣♣                        ▤♣♣♣♣♣♣♣♣♣♣♣♣♣♣♣♣♣♣♣♣▤
▤  ▤                  ▤      ▤♣♣♣♣♣♣           ☠          ▤♣♣♣♣♣♣♣♣♣♣♣♣♣♣♣♣♣♣♣♣▤
▤  ▤▤▤▤▤▤▤▤▤▤▤▤   ▤   ▤   ▤▤▤▤♣♣♣♣♣♣♣                     ▤♣♣♣♣♣♣♣♣♣♣♣♣♣♣♣♣♣♣♣♣▤
▤                 ▤          ▤♣♣♣♣♣♣♣♣                    ▤♣♣♣♣♣♣♣♣♣♣♣♣♣♣♣♣♣♣♣♣▤
▤▤▤▤▤▤▤▤▤▤▤▤▤▤▤▤▤▤▤▤▤▤▤▤▤▤▤▤▤▤▤▤▤▤▤▤▤▤▤▤▤▤▤▤▤▤▤▤▤▤▤▤▤▤▤▤▤▤▤▤▤▤▤▤▤▤▤▤▤▤▤▤▤▤▤▤▤▤▤▤