▤▤▤▤▤▤▤▤▤▤▤▤▤▤▤▤▤▤▤▤▤▤▤▤▤▤▤▤▤▤▤▤▤▤▤▤▤▤▤▤▤▤▤▤▤▤▤▤▤▤▤▤▤▤▤▤▤▤▤▤▤▤▤▤▤▤▤▤▤▤▤▤▤▤▤▤▤▤▤▤
▤♣♣♣♣♣♣♣♣♣♣♣♣♣♣▤             ▤                 ▤   ▤▤     ▤      ▤   ▤   ▤    ▤▤
▤♣♣♣▤▤▤▤                     ▤                            ▤                    ▤
▤♣♣♣▤▤▤▤                                                     ▤▤▤▤▤▤▤▤▤▤▤▤▤▤▤▤▤▤▤
▤                            ▤             ♣              ▤                    ▤
▤♣♣♣                         ▤    ☠        ♣                                   ▤
▤♣♣♣♣    ▤▤▤▤▤▤▤▤            ▤                            ▤                    ▤
▤ ♣♣♣♣   ▤      ▤            ▤                   ☠        ▤                    ▤
▤  ♣     ▤      ▤            ▤           ▤                ▤     ♣♣♣♣♣♣♣♣♣♣♣♣♣♣♣▤
▤        ▤      ▤▤▤▤▤▤▤▤▤▤▤  ▤           ▤                ▤       ♣♣♣♣♣♣♣♣♣♣♣♣♣▤
▤   ☺♣   ▤                   ▤           ▤   ☠            ▤                    ▤
▤        ▤                   ▤           ▤▤▤▤▤▤▤▤▤▤▤   ▤▤▤▤                    ▤
▤  ▤▤▤  ▤▤▤▤▤▤▤▤▤▤▤▤▤▤▤▤▤▤▤▤▤▤▤▤▤▤▤▤▤▤▤▤▤▤                ▤                    ▤
▤                            ▤    ☠      ▤                ▤                    ▤
▤  ⌂     ⌂         ♣♣♣       ▤           ▤                ▤                    ▤
▤                   ♣        ▤           ▤                ▤                    ▤
▤  ▤▤▤▤▤▤▤▤▤▤▤▤▤▤▤▤▤▤▤▤▤▤▤   ▤           ▤                ▤                    ▤
▤  ▤                     ▤   ▤             ☠              ▤                    ▤
▤  ▤                     ▤ ☠ ▤                            ▤                    ▤
▤  ▤       ▤  ⌂  ▤       ▤   ▤                            ▤▤▤▤▤▤▤▤▤▤▤▤▤▤▤▤▤▤▤▤ ▤
▤  ▤       ▤▤▤▤▤▤▤       ▤▤▤▤▤                    ☠       ▤       ♣♣♣♣♣♣♣♣♣♣♣♣♣▤
▤  ▤                         ▤                            ▤      ♣♣♣♣♣♣♣♣♣♣♣♣♣♣▤
▤  ▤                         ▤                            ▤    ♣♣♣♣♣♣♣♣♣♣♣♣♣♣♣♣▤
▤  ▤  ▤▤▤▤▤▤▤▤▤▤▤▤▤▤▤▤▤▤▤▤▤▤▤▤            ♣♣♣♣♣♣          ▤   ♣♣♣♣♣♣♣♣♣♣♣♣♣♣♣♣♣▤
▤  ▤                         ▤             ♣♣♣♣           ▤♣♣♣♣♣♣♣♣♣♣♣♣♣♣♣♣♣♣♣♣▤
▤  ▤         ⌂               ▤                            ▤♣♣♣♣♣♣♣♣♣♣♣♣♣♣♣♣♣♣♣♣▤
▤  ▤                         ▤                            ▤♣♣♣♣♣♣♣♣♣♣♣♣♣♣♣♣♣♣♣♣▤
▤  ▤                         ▤                            ▤♣♣♣♣♣♣♣♣♣♣♣♣♣♣♣♣♣♣♣♣▤
▤                            ▤                            ▤♣♣♣♣♣♣♣♣♣♣♣♣♣♣♣♣♣♣♣♣▤
▤▤▤▤▤▤▤▤▤▤▤▤▤▤▤▤▤▤▤▤▤▤▤▤▤▤▤▤▤▤▤▤▤▤▤▤▤▤▤▤▤▤▤▤▤▤▤▤▤▤▤▤▤▤▤▤▤▤▤▤▤▤▤▤▤▤▤▤▤▤▤▤▤▤▤▤▤▤▤▤